42.xo
.................x...x........x...x......x
.......x............x....................x
...x.....xx.....x..x.....x...x..........x.
.........x......x..x.....x..x...x.....x...
.xx...xx.x.....x...x.x.x.x.x...x.........x
.........x..x.............x.......x.x..x..
......x..x...........x.....x...x.x........
..................x.x.........x..x....x...
.x.x.x............x....xxx.....x...x......
..x..x....x.x...x..........x..............
..x....x.x...................x.xxxx.......
.xx...........x.x....................x....
x...x.....xx..x.xx..........x.x.x.....x.x.
......xxx...x.....x..........x..........x.
..x...x...x.x................x.....x.....x
.x..........xx................x.x...x...x.
..........x.........x......x.x............
...........x..............................
......x..xx.....x.....x..xx.x..x........x.
.....xx..x...................x....x.......
.x....x.x.......x.......................x.
xx..x....x........x...................x...
x...........xx.............x.............x
.x...x............x..x............x.x.....
..x.x.......................xx.xx......x..
...x.x...x..............xx.x.x.....xx.x...
x........x...............x.x.x.x..........
..................xx...x............xxx.x.
x.....x.x......x.....x.xx..x......x.x....x
........x................x...........x....
.......x..................x....x.....x....
...............x...........x....x.x.......
........xx..x............x.x..xx...x..xx..
..x.....x.x.....x.............x.......xx..
.x.............x........xx.x.x........x...
.......x..x..x....x......xxxx.............
....xx.........x......xx......x...........
...x....x.x.......x................x......
..............x...........x.........x.....
.......x....x.....x...x...............x...
xx.....x.x........x.....x.x......x...x....
xx...x........xx.x....x...x.....x.x...x...