20.xo
x..x..x.......x.....
.x.........x........
....x......x....x...
x......x.x..x..x....
............x.......
x......x....x.......
........x...........
.......x......x.....
.....x.....xx.......
xx........x.........
.....x...xx.........
x...x.............x.
.x............x.....
........xx..........
..x.....x...x..x....
x..x................
..x.......x........x
.............xx....x
...x.......xxx..x...
......x..x..........